 *** Trigger List ***       
{
        timeline on = on
        timeline off = off
	    Image on = img_on
	    Image off = img_off
        Color on = col_on
        Color off = col_off
        Video_on = video_on
        Video off = video_off
       	Video stop = video_stop
        Video play = video_play
        Video reset = video_reset
        Video position = video_position <param> 
        Shared video on = shared_video_on
        Shared video off = shared_video_off
        Shared video number = shared_video_num <int> 
        Shared video reset = shared_video_reset
        Slideshow on = slide_on
        Slideshow off = slide_off
        Slideshow new = slide_new
        Slideshow number = slide_num <int>
        Camera on == cam_on
        Cmera off == cam_off
        Device Number == cam_num
	Cam Sampler on = sampler_on
	Cam Sampler off = sampler_off
	Cam Sampler number = sampler_num
	Cam Sampler buffer number = sampler_buffernum 
        Kinect on = kinect_on
        Kinect off = kinect_off
        Mask on = mask_on
        Mask off = mask_off
        Mask invert on = mask_invert_on
        Mask invert off = mask_invert_off
	timeline stop = timeline_stop //main page trigger
 }       
        
